6 8
NN NN NN NN NN NN NN NN NN NN NN NN NN NN 
NN NN NN NN NN NN NN NN NN NN NN NN NN NN 
NN NN NN NN NN NN NN NN NN NN NN NN NN NN 
NN NN NN NN NN NN NN NN NN NN NN NN NN NN 
NN RD RL RL RL DL NN RD RL RL RL DL NN NN 
NN UD NN NN NN DU NN UD NN NN NN DU NN NN 
NN UR LR LD NN RU RL UL NN DR LR LU NN NN 
NN NN NN UD NN NN NN NN NN DU NN NN NN NN 
NN RD RL UL NN DR LR LD NN RU RL DL NN NN 
NN UD NN NN NN DU NN UD NN NN NN DU NN NN 
NN UR LR LR LR LU NN UR LR LR LR LU NN NN 
NN NN NN NN NN NN NN NN NN NN NN NN NN NN 
NN NN NN NN NN NN NN NN NN NN NN NN NN NN 
