4 1
DR LR LD NN NN NN NN NN NN 
RU DL UR LR LR LR LR LD NN 
NN RU DL NN NN NN NN UR LD 
NN NN RU DL NN NN NN NN UD 
NN NN NN RU DL NN NN NN UD 
NN NN NN NN RU RL RL RL UL 