0 5
RD RL RL DL 
UD NN NN DU 
UD NN NN DU 
UD NN NN DU 
UD NN DR LU 
UD NN DU NN 
UR LR LU NN 