2 1
NN NN NN NN NN 
NN DR LR LD NN 
NN RU RL UL NN 
NN NN NN NN NN 
NN NN NN NN NN 