2 1
NN NN NN NN NN 
DR LR LR LR LD 
RU RL DL NN UD 
NN NN DU NN UD 
NN NN RU RL UL 