RD RL DL NN NN NN NN NN 
UD NN DU NN NN NN NN NN 
UD NN NN NN NN NN NN NN 
UR LR LR LR LR LR LR LD 
DR LR LR LR LR LR LR UD 
RU RL RL RL RL RL DL UD 
DR LR LR LR LR LR LU UD 
RU RL RL RL RL RL RL UL 