2 7
NN NN NN NN NN NN NN NN NN NN DR LR LR LR LR LD 
NN NN NN NN NN NN NN NN NN NN DU NN NN NN NN UD 
DR LD NN NN NN NN NN NN NN NN DU NN NN NN NN UD 
DU UD NN NN NN NN NN NN NN NN DU NN NN NN NN UD 
DU UD NN NN NN NN NN NN NN NN DU NN NN NN NN UD 
DU UD NN NN NN NN NN NN NN NN DU NN NN NN NN UD 
DU UD NN NN NN NN NN NN NN NN DU NN NN NN NN UD 
DU UR LR LR LR LR LR LR LR LR LU NN NN NN NN UD 
DU NN NN NN NN NN NN NN NN NN NN NN NN NN NN UD 
RU RL RL RL RL RL RL RL RL RL RL RL RL RL RL UL 
