RD RL DL NN NN NN 
UD NN DU NN NN NN 
UD NN DU NN NN NN 
UR LR LU NN NN NN 
NN NN NN NN NN NN 
NN NN NN NN NN NN 